11111111
1PC0C001
10010011
1C1E1001
11111111