1111111111111111111111111111
10011P111111C111111111111111
1101100100000000111111111111
1000C00000C0000C001111111111
1000000000000000001111111111
1C0001C00000C000001111111111
1000C11111100000001111111111
1100000110011111000000111111
1111111111001110000000E00111
1111111111100000000000011111
1111111111111111111111111111
