
1111111111111111111111111111
100111P11111C111111111111111
1101100100000000111111111111
1000C00000C0000C001111111111
1000000000000000001111111111
1C0001C00000C000001111111111
1000C11111100000001111111111
1100X00110011111000000111111
1111101111001110000000000111
11111111110001100000011E1111
1111111111111111111111111111