1111111111111111111
1E0111P11111C111111
1111100100000000111
1000C00000C0000C001
1000000000000000001
1C0001C00000C000001
1X00C11111100000001
1100000110011C11111
1111111111011E10111
1110111111000000111
1111111111111111111