
1111111111111111111
100111P11111C111111
1111100100000000111
1000C00000C0000C001
1000000000000000001
1C0001C00000C000001
1000C11111100000001
1100000110011011111
1111111111011E10111
1111111111000000111
1111111111111111111