1111111111111111111
111111P111111111111
1111100111111111111
1000C00000C0000C001
1000000000000000001
1C0X01C00000C000001
1000C11111100000001
1111111111001111111
1111111111000E00111
1111111111111000111
1111111111111111111
