1111111111111111111
111111P111111111111
1111100111111111111
1000C00000C0000C001
1000000000000000001
1C0001C00000C000001
1000C11111100000001
11111111110011C1111
1111111111011E10111
111C111111000000111
1111111111111111111