1111111111111111
1111111111111111
1111111111111111
1111111111111111
1PCXE11111111111
1111111111111111
