1111111111111111
1111111111111111
1111111111111111
1111111111111111
11E0111111111111
1P1C111111111111
1111111111111111
